##########################
#  1  #         o        #
#     #         o        #
#  *  #    2    o        @
#     #         o        #
# *   #         o        #
#     o         #        #
#     o         #        #
#     o         #        #
##########################
