###########
# 1  #    @
#    #    #
#    #    #
#    #    #
#    #    #
# *  #    #
#    o    #
###########
