##################
#       # @   o  #
#   1   #     o  #
#       #oooooo  #    
#       #        #
#       #        #
#       #        #
#       °        #
#       %     2  #
#       °        #
#       #        #
#  *    #        #
#       #        #
#       O        #
##################
