###############
#      °      #
#  1  *%°     #
#            @#
#  2* o  O*3  #
###############
